############################################
#d         #         #                   d #
#          #         #                     #
#          #         #                     #
#          ###########                     #
#                             #####        #
#                             #   #        #
#                  @          #   #        #
#       ########              #####        #
#              #                           #
#              ########                    #
#              #       #                   #
#              #        #                  #
#              #         #                 #
#d             #          #               d#
############################################
