############################################
#          #         #                     #
#          #         #                     #
#          #         #                     #
#          ###########                     #
#                                          #
#                                          #
#                  @                       #
#       ########                           #
#              #                           #
#              ########                    #
#              #       #                   #
#              #        #                  #
#              #         #                 #
#              #          #                #
############################################
